WWWWWWWWWW
W  V K  CW
W  HHHH  W
W C  b  BW
W C  WXXXW
W    W    
W   WW   W
W    W   W
W S C  T W
WWWWWWWWWW