WWWWWWWWWW
W   A   YW
W  HH  HHW
W b  B R W
WXXXXWXXXW
W    W    
W   WW   W
W S  W   W
W FC  T  W
WWWWWWWWWW