WWWWWWWWWW
W       CW
W        W
W C  R RBW
W C  WXXXW
W    W    
W   WW   W
W    W   W
W S C  T W
WWWWWWWWWW